###############################
#.............................#
#.G...........................#
#.............................#
#.............########........#
#.............#..E.#M.........#
#.............#...............#
#.S...........########........#
#................G#G..........#
###############################